NO ./textures/BRICK_1A.xpm
SO ./textures/BRICK_2B.xpm
WE ./textures/WOOD_1C.xpm
EA ./textures/SLUDGE_1A.xpm

F 100,100,100
C 0,170,219


        1111111111111111        
    1   11111 1 1011111111111111111111
    1111100011 110001100000000011111111
    100000101010111100000000001
    111110000000000000000000001111111
1111111110110000011100000000000001
1000000000010011111101111010111111
11110011110111001100000010001 
  1101111001111110001001000111 
111001   10001000000000010001
10000111100000001100000000001111111
10000000000000001101N100111000001
1100000111010100000111111  11111
  110111 11101011100000001111
   11111 1111111 111111111111 
                        111



						  







