
NO ./textures/wall.xpm
SO ./textures/wall.xpm
WE ./textures/wall_west.xpm
EA ./textures/wall_east.xpm

F 100,100,100
C 0,170,219

         111111          
        11111 1 1111111111111111111111
    1111100011 110001100000000000001111
    100000101010111100000000000000001
    111110000000000100000000000001111
1111111110110000011100000000000001
1000000000010011111101111010111111
11110011110111001100000010001
  1101   1001111110101001000111
111001   10001000000000010001
10000111100000001100000000001111
10000000000000001101W100111000001
1100000111010101111111111  11111
  110111 1110101 10111101111
   11111 1111111 111111111111
                        11